{
	"name" : "Mountain island",
	"map" : {
		"width" : 11,
		"depth" : 11,
		"height" : [
			0, 0, 0, 0, 0, 0, 0, 0, 0, 0, 0,
			0, 0, 0, 0, 0, 0, 0, 0, 0, 0, 0,
			0, 0, 1, 1, 1, 1, 1, 1, 1, 0, 0,
			0, 0, 1, 2, 3, 3, 3, 2, 1, 0, 0,
			0, 0, 1, 3, 4, 4, 4, 3, 1, 0, 0,
			0, 0, 1, 3, 4, 4, 4, 3, 1, 0, 0,
			0, 0, 1, 3, 4, 4, 4, 3, 1, 0, 0,
			0, 0, 1, 2, 3, 3, 3, 2, 1, 0, 0,
			0, 0, 1, 1, 1, 1, 1, 1, 1, 0, 0,
			0, 0, 0, 0, 0, 0, 0, 0, 0, 0, 0,
			0, 0, 0, 0, 0, 0, 0, 0, 0, 0, 0,
		]
	},
	
	"waterHeight" : 1.5,

}